NO ./textures/north_texture.xpm
SO ./textures/south_texture.xpm
WE ./textures/west_texture.xpm
EA ./textures/east_texture.xpm

C 165, 242, 246

F 1, 38, 46

111111111
100000001
100N00001
100000001
100000001
100000001
100000001
100000001
111111111
