NO ./textures/north_texture.xpm
SO ./texture/south_texture.xpm
WE ./textures/west_texture.xpm
EA ./textures/east_texture.xpm

C 165, 242, 246

F 1, 38, 46

111111111
100000001
101100001
100000001
1000N0001
101000001
100011001
100001001
111111111
