NO ./textures/north_texture.xpm
SO ./texture/south_texture.xpm
WE ./textures/west_texture.xpm
EA ./textures/east_texture.xpm

C 165, 242, 246

F 1, 38, 46

11111111
10N00001
10000001
10100001
10000101
10001101
10000001
11111111
